111111111111111111111
11000C0000011001110E1
11C11100C111111C00011
100000011001100001111
1C0000000000001100P11
111111111111111111111
