111111111111111
100C11C00001101
1C01111100C0011
1100000C0010001
110011C11110101
110010P01110111
11C00C1100000E1
111111111111111
