111111111111111111111111
1000001100C111E0000100P1
1110000001111110010110C1
11111C000001111100001011
110000011000000001000001
111111111111111111111111
