111111111111111111
11100000001100C111
1P0CC0011000000001
111111111111111111
