111111111111111111111
110000000P110000011C1
111111111111111111111
1E00000000011000C0001
111111111111111111111
