11111111111111
1E0100000000C1
10000111110001
1P0011E00000E1
11111111111111
