1111111111101
11000P11C0011
1E000000000C1
1111111111111
