11111111111111111
110P00000011110E1
10000111100011001
10001111110000001
11111111111111111
