111111111111111111
11000000000011CC01
11C00E000000000111
111111111111111111
