1111111111111
11000P11C0000
1E000000000C1
1111111111111
