111111111111111
100000101110011
11110000C10E001
1P000111000101
111111111111111