111111111111
1100P00C0VE1
111111111111
