1111111
100P001
1111V01
1C00001
1001111
1V00011
11110C1
1011001
1V00011
11110C1
1000001
1C00001
1001111
1V00011
11110C1
1000001
1C00001
1001111
1V00011
11110C1
1000001
1C00001
1001111
1V00011
111V001
1C00011
100C111
1100011
1E01111
1111111
