111111111
1000000C1
1P011E001
111111111
