111111111111111111111111
1000001100C111E000010001
1110000001111110010110C1
11111C000001111100001011
11P000011000000001000001
111111111111111111111111
