111111111111
11V0P00C00E1
111111111111