11111111111
1000V0000E1
1P00000C001
11111111111