111111111111111111111111111
1110C0011110000C111C0011111
1111V0001110V00011110000111
111000001111001110000111111
10011100000V001100110000C11
1111C111000000V000000011111
11E00011001100000V11000C111
111100000001110000111000011
11C00011010011100C0000C0011
1011P000010000V111111000111
100100000C01100000000010001
100011110001111100100100111
111111111111111111111111111
