1111111111111
100C0000V11E1
1P0111000C001
1111C00V00111
1111111111111
