11111111111111111
11V0C1V000V111C01
1P00V11000CV11VC1
111000V0010000001
1111V00011V00V1E1
1V00000V111V0C011
11CV10V1000110V11
11111111111111111
